###########
#   #     #
### # ### #
#   #   # #
# ### # # #
#     # # #
##### ### #
#   #     #
# # ##### #
#       # #
###########
